000000000
000010000
000100110
000110000
000111010
001000011
001001010
001010000
001010110
001011101
001100011
001100110
001101010
001101101
001110000
001110011
001110110
001111101
010000110
010010000
010100000
010110000
011000000
011100000
100000000
