0000000000
0000100000
0001001101
0001100000
0001110011
0010000111
0010010011
0010100000
0010101100
0010111001
0011000111
0011001101
0011010011
0011011010
0011100000
0011100110
0011101100
0011111001
0100001101
0100100000
0101000001
0101100000
0110000001
0111000001
1000000001
